WWWWWWWWWWWWWWWWWWWWWWWWWWWW
W..P1......................W
W....WWWW....WW....WWWW....W
W....W.......WW.......W....W
W.WWWW....WWWWWWWW....WWWW.W
W.........W......W.........W
W....WW...W......W...WW....W
W.........W......W.........W
W.WWWW....WWWWWWWW....WWWW.W
W....W.......WW.......W....W
W....WWWW....WW....WWWW....W
W......................P2..W
WWWWWWWWWWWWWWWWWWWWWWWWWWWW