WWWWWWWWWWWWWWWW
...............W
W..P1......P2..W
W......WWW......
WWWWWWWWWWWWWWWW