WWWWWWWWWWWWWWWWWWWWWWWWWWWW
W..........................W
W..P1....WW....W....WW.....W
W........W.....W.....W.....W
W..WWW...W..WWWWW..W...WWW.W
W......W.W.........W.W.....W
W.WWW.W...W......W...W.WWW.W
W....W...W........W...W....W
W..WW...W..WWWWWW..W...WW..W
W...W....W....W.....W..P2..W
W..W..W.....W....W.....W...W
W.WW..W.WWW..W..WWW.W...WW.W
W..........................W
WWWWWWWWWWWWWWWWWWWWWWWWWWWW