WWWWWWWWWWWWWWWWWWWWWWWWWWWW
W..P1......................W
W......WWWWWWWWWWWWWW......W
W.WWWW.W............W.WWWW.W
W.W....W.WWWWWWWWWW.W....W.W
W.W.WWWW.W........W.WWWW.W.W
W.W......W........W......W.W
W.W.WWWW.W........W.WWWW.W.W
W.W....W.WWWWWWWWWW.W....W.W
W.WWWW.W............W.WWWW.W
W......WWWWWWWWWWWWWW......W
W......................P2..W
WWWWWWWWWWWWWWWWWWWWWWWWWWWW