WWWWWWWWWWWWWWWWWWWWWWWWWWWW
W.P1.....W.........W.......W
W....W...W...WWW...W...W...W
WWWW.W...W...W.....W.W.WW..W
W....W...W...W.....W.W.....W
W.WWWW.WWW...WWWWW.WWWWWW..W
W....W.W...........W.......W
W.WWWW.WWWWWWW..W..WWWWWW..W
W....W..........W..W.......W
WWWW.W...W......W..W.W.WW..W
W....W...WWW....W..W.W.....W
W....W..........W...WP2....W
W..........................W
WWWWWWWWWWWWWWWWWWWWWWWWWWWW
