WWWWWWWWWWWWWWWWWWWWWWWWWWWWWW
W.P1.........................W
W.....W....................W.W
W......WW................WW..W
W.......WWW............WWW...W
W........WWWW........WWWW....W
W.........WWWWW....WWWWW.....W
W..........WWWWWWWWWWWW......W
W..........WWWWWWWWWWWW......W
W.........WWWWW....WWWWW.....W
W........WWWW........WWWW....W
W.......WWW............WWW...W
W......WW................WW..W
W.....W....................W.W
W..........................P2W
WWWWWWWWWWWWWWWWWWWWWWWWWWWWWW
