WWWWWWWWWWWWWWWWWWWWWWWWWWWWWW
W.P1.........................W
W.....WWWWWWWWWWWWWWWWWWWWWW.W
W.....W......................W
W.....W.WWWWWWWWWWWWWWWWWWWWWW
W.....W.W....................W
W.....W.W.WWWWWWWWWWWWWWWWWW.W
W.....W.W.W..................W
W.....W.W.W.WWWWWWWWWWWWWWWWWW
W.....W.W.W.W................W
W.....W.W.W.WWWWWWWWWWWWWWWWWW
W.....W.W.W..................W
W.....W.W.WWWWWWWWWWWWWWWWWW.W
W.....W......................W
W..........................P2W
WWWWWWWWWWWWWWWWWWWWWWWWWWWWWW
