WWWWWWWWWWWWWWWW
W..............W
W.P1...........W
W.....WWWW.....W
W....W....W....W
W....W....W....W
W.....WWWW.....W
W..........P2..W
WWWWWWWWWWWWWWWW
