WWWWWWWWWWWWWWWWWW
W................W
W..P1..........W.W
W..........WWW...W
W.W..............W
W...........P2...W
W.....WW.........W
WWWWWWWWWWWWWWWWWW
