WWWWWWWWWWWWWWWW
W..............W
W.P1..W...W....W
W.....W...W....W
W.....W...W....W
W....P2........W
W..............W
WWWWWWWWWWWWWWWW
