WWWWWWWWWWWWWWWWWW
W................W
W.P1.............W
W....WWWWWWWW....W
W................W
W.............P2.W
W....WWWWWWWW....W
W................W
WWWWWWWWWWWWWWWWWW
