WWWWWWWWWWWWWWWW
W..............W
W.P1...WW......W
W......WW......W
W......WW......W
W......WW...P2.W
W..............W
WWWWWWWWWWWWWWWW
