WWWWWWWWWWWWWWWWWW
W................W
W.P1.............W
W....W.....W.....W
W....W.....W.....W
W....WWWWWWW.....W
W................W
W.............P2.W
WWWWWWWWWWWWWWWWWW
