WWWWWWWWWWWWWWWWWWWWWWWWWWWWWWWW
W.P1...........................W
W..............................W
W..........WW......WW..........W
W.........WWWW....WWWW.........W
W.........WWWWWWWWWWWW.........W
W..........WWWWWWWWWW..........W
W...........WWWWWWWW...........W
W............WWWWWW............W
W.............WWWW.............W
W..............WW..............W
W..............................W
W...........................P2.W
WWWWWWWWWWWWWWWWWWWWWWWWWWWWWWWW
